                   _                             _   _   _           _ 
                  | |       ___  __   __   ___  | | | | | |  _ __   | |
                  | |      / _ \ \ \ / /  / _ \ | | | | | | | '_ \  | |
                  | |___  |  __/  \ V /  |  __/ | | | |_| | | |_) | |_|
                  |_____|  \___|   \_/    \___| |_|  \___/  | .__/  (_)
                                                            |_|        
                  